60,60,60,60,60,60,61,32,0,1
10,11,60,60,60,70,71,0,1,2
20,21,60,60,70,71,0,1,2,3
21,60,60,70,71,0,1,2,2,13
60,60,70,71,0,1,2,3,4,2
60,60,61,32,33,34,2,13,14,2
10,11,61,32,43,64,2,2,3,4
20,21,61,32,32,33,34,2,13,14
30,60,61,32,32,43,44,12,12,12
30,70,71,32,32,32,32,32,32,32
